  0 1 2 3 4 5 6 7 8 9
0 x - x x - - - - - -
1 - - - - - - - - - x
2 - - x - - - - - - -
3 - - - - - - - - - -
4 - - - x x x - x - -
5 - - - - - - - x - -
6 - x x x x - - x - -
7 - - - - - - - - - -
8 - - - - - x - - - -
9 x x - - - x - - - x