x-xx------
---------x
--x-------
----------
---xxx-x--
-------x--
-xxxx--x--
----------
-----x----
xx---x---x