  0 1 2 3 4 5 6 7 8 9
0 - - - - - - x - x -
1 - - - - - - - - - -
2 - - - - - x - x - -
3 - - - - - - - - - x
4 - - - - - - x - - x
5 - - - - - - x - - -
6 x - - - - - - - x x
7 x - - - - - - - - -
8 x - - - - - - x x x
9 - - x x x x - - - -