  0 1 2 3 4 5 6 7 8 9
0 - - - - - - - - - -
1 - - - - - - - - - -
2 - - - - - - - - - -
3 - - - x - - - - - -
4 - - - - - - - - - -
5 x x x x - x - - - -
6 - - - - - - - - - x
7 x - - x x x - x - x
8 x - - - - - - - - -
9 - - x x - x x x - x